NO ./assets/barrel_bottom.xpm
SO ./assets/barrel_side.xpm
WE ./assets/barrel_top_open.xpm
EA ./assets/barrel_top.xpm                                                                                                                                                        

F 220,100,0
C 225,30,0

11111111111111111111111111111
10000010000000010000000010001
11110111111111011100000010001
11110111111111010101010010001
11000000110101011100000010001
10000000000000000000000000101
11000001110101011111011110011
10000001000000000000000000001
10000001111110000001111100001
10000000000010000000000100001
10111100000000N00000000100001
10100100000100000000100100001
10000100000100000000111100001
10000100000000000000100000001
11111111111111111111111111111
