                         NO                                    ./assets/barrel_bottom.xpm                            

SO ./assets/barrel_side.xpm






WE ./assets/barrel_top_open.xpm

EA ./assets/barrel_top.xpm

F 220,100,0

C 225,30,0




     1111 111
111111001110111
100010001000001
100010000000001
100010000010001
101110110110101
100010000010001
111011101011111
100000101000001
101110101011101
100010001000001
111010111011101
100010000010001
101110111110111
10000N0000001
1011111111111
100000001
100111111
11011111111111111
 1000000000000001
 1111111111111111



