NO ./assets/barrel_bottom.xpm
SO ./assets/barrel_side.xpm
WE ./assets/barrel_top_open.xpm
EA ./assets/barrel_top.xpm

F 220,100,0
C 225,30,0

11111111111111111111111111111
10000000000000000000000000001
11110111111111011100000010001
11110111111111010101010010001
11000000110101011100000010001
10000000000000000000000000101
11000001110101011111011110011
10000000000000000000000000001
10000000000000000000000000001
10000000000000000000000000001
10000000000000N00000000000001
10000000000000000000000000001
10000000000000000000000000001
10000000000000000000000000001
10000000000000000000000000001
10000000000000000000000000001
10000000000000000000000000001
10000000000000000000000000001
10000000000000000000000000001
10000000000000000000000000001
10000000000000000000000000001
10000000000000000000000000001
10000000000000000000000000001
10000000000000000000000000001
10000000000000000000000000001
10000000000000000000000000001
10000000000000000000000000001
11111111111111111111111111111
11110111 1110101 101111010001
11111111 1111111 111111111111
11111111111111111111111111111
111111111  1
1111111 1  1
1       1  1
1
